apple	n
river	n
mountain	n
house	n
garden	n
book	n
friend	n
ocean	n
cloud	n
city	n
run	v
jump	v
write	v
sing	v
dance	v
read	v
build	v
grow	v
paint	v
swim	v
red	a
bright	a
quick	a
strong	a
happy	a
cold	a
soft	a
dark	a
loud	a
sharp	a